------------------------------------------------------------------------------------------------------------------------------------------------------------------------------------
------------------------------------------------------------------------------------------------------------------------------------------------------------------------------------
------------------------------------------------------------------------------------------------------------------------------------------------------------------------------------
------------------------------------------------------------------------------------------------------------------------------------------------------------------------------------
-----------------E--------------------------------E-----------ooo---------------------------E---------------------------------------------------------------------------------------
--------------SSSSSSSSSSS------------?QQQQQQ---------SSSSSSSSSSSS----SSSSSSSSSSSSX--------------E-----------------------?------------------------------------------------XX---------
---------------------------------------------------------------------------------X------E-------------------------------E-----------------------------------------------XXX---------
---------------------------------------------------------------------------------X-----------------------------------------E-------------------------------------------XXXX---------
-------------------E----------------------------------------E--------------------X--E-------------------------------------<>--------E--EE-----------------------------XXXXX---------
--------------SSSSSS?SSSS-----QQQ?---S---------------------<>------S------------?X-<>--------------------?QQ--------------[]-------<>--<>---------E------------------XXXXXX---------
-----------------------------------------------------------[]----------------E---X-[]-----------------------------B-------[]---<>--[]--[]---------------------------XXXXXXX---------
-----------------------------------------------------------[]---------------<>---X-[]----------------B------------b-------[]---[]--[]--[]--------------------------XXXXXXXX---------
--------------------------------------EE-------------------[]---------------[]---X-[]-E--------------b-E-E--------B-------[]---[]--[]--[]-------------------------XXXXXXXXX--------X
XXXXXXXXXXXXXXXXXXXXXXXXX----XXXXXXXXXXXX--------XXXXXXXXXXXXXXXXX----------XXXXXXXXXXXXXXXXXX---XXXXXXXXXXXXXXXXXXXXXXXXXXX---XX--XXXXXXXXXXXXXXXX----XXX----XXXXXXXXXXXXXXXXXX---X
