------------------------------------------------------------------------------------------------------------------------------------------------------------------------------------------------------------
------------------------------------------------------------------------------------------------------------------------------------------------------------------------------------------------------------
------------------------------------------------------------------------------------------------------------------------------------------------------------------------------------------------------------
---------------------------------------------?--------------------------------------------------------------------------------------------------------------------------------------------------------------
------------------------------------------------------------ooooo---------------------------------E----------------------------------------------------------------------E----------------------------------
-----------------------------E--------------------------XX--XXXXX--------------------------------<>-----------------XXX--------XXXX--------XXX--------------XXXXXXX--------XXXXXXX--------XXXXEX------------
------------------------E-----------XX-------XX-----XX---------------------E---------------------[]--------XX-----------------------------------------XX----------------------------------------------------
---------------------------XX--------------------------------------------------------------------[]------------------------oo-------------------------------------------------------------------------------
---------------------------------------------------------------------------------------------E---[]------------------------SS-------------------------------------------------------------------------------
--S-------------XXXXX-------o------------------------------------------XX--------------XXX--<>---[]----------------------------------------------XX---------------------------------------------------------
----------------------------o--XX-----------------------------------------------E-----------[]---[]---------------------------------------------------------------------------------------------------------
SS-SS---------------------------------------------------------------------------------------[]---[]---------------------------------------------------------------------------------------------------------
SS-SS---------------------------------------------------------------------------------------[]---[]----------------o---o--------------------------------------------------------------------------------X---
XXXXXXXXXXXX------------------------------------------------XXXXXXXX------------XXXXXXX-----[]---XX-XXX------------X---X----XX--------XXX-------------------------------------------------------------X-XXXX
