--------------------------------------------------------------------------------------------------------------------------------------------------------------------------------------------------------------------------------------------------------------------------------------------------------------------------------
--------------------------------------------------------------------------------------------------------------------------------------------------------------------------------------------------------------------------------------------------------------------------------------------------------------------------------
--------------------------------------------------------------------------------------------------------------------------------------------------------------------------------------------------------------------------------------------------------------------------------------------------------------------------------
--S-----------------------------------------------------------------------------------------------------------------------------------------------------------------------------------------------------------------------------------------------------------------------------------------------------------------------------
-------------------------------------------------------------------------------------------------------------------------------------------------------------------------------------------------------------------------------------------------------------------------------------------------------------E------------------
SS-SS---------------------XXXX----------XXXXXXXXXXXXXXXX--------------------------------------------------------------------------XX--------XXX--------XXXX---------XX----------------------XXXX------------------------------------------------------------------------------------------XX---------E-SSSSS------------------S-
SS-SS----------------------------------------------------------------------------------------------------------------------------XXX--------XXX--------XXXX---------XX-------------------------------------------------------------------------------------------------------------------XXX------E-----------------------------
--------------------------------------------------------------------------------------------------------------------------------XXXX--------XXX--------XXXX---------XX------------------------------------------------------------------------------------------------------------------XXXX------------------------------------
S-S-SSS------------------------------------------------------------------------------------------------------------------------XXXXX--------XXX--------XXXX---------XX-----------------------------------------------------------------------------------------------------------------XXXXX---------------------------------S--
S-S-SSS-----QQQQ--------------------------------------------------------------------------------------------------------------XXXXXXS-------XXX--------XXXX---------XX--------------------------------------------------------------------ooo-----------------------------------------XXXXXX------------SSS---------------------
SSSSSSS-------------------------------------------------------------------B-------------------E------------------------------XXXXXXX--------XXX--------XXXX---------XX----------------------------------------------------------------------------------------------------------------XXXXXX-------------------------------E----
-S-S-SS------------------------------------------------------------------Eb-------------------------------------------------XXXXXXXX--------XXX--------XXXX---------XX---------------B---------------------------E--------------------------------------------------------------------XXXXXX----------------------------------E-
-S-S-SS-------------------------------------------------------E-----------BEE---------------------------E-EE---------------XXXXXXXXX--------XXX--------XXXX---------XX---------------b------------------------------------------EE-------------------EE-E------------------EE---X-----XXXXXX------------------------------------
XXXXXXXXXXXXXXXXXXXXXXXXXXXXXXXX-----XXXXXXXXX--XX--XX--XXXXXXXXXXXXXXXXXXXXXXXXXXXXXXXXXXXXXXXXXXXXXXXXXXXXXXXXXXXXXXXXXXXXXXXXXXXXXX------XXX--------XXXX---------XXXXXXXXX---XXXXXXXXXXXXXXXXXXXXX--XX--XXXXXXXX--XXXXXXXXXXXXXXXXXXXXXXXX--XXXXXXXXXXXXXXXXXXXXXXXXXX--XXXXXX-----XXXXXX----------XXXXXXXXXXXXXXXXXXXXXXXXXX
