--------------------------------------------------------------------------------------------------------------------------------------------------------------------------------------
--------------------------------------------------------------------------------------------------------------------------------------------------------------------------------------
---------------------------------------------------E-------------------------------------------?--------------------------------------------------------------------------------------
--------------------E-----------------------------<>-------------------------ooo------------------------------------------------------------------------------------------------------
--------------------------------------------------[]-------------------------ooo------------------------------------------------------------------------------------------------------
--------------XXXXXEXXXXX-----------------------XX[]X------------XXX--------XXXX--------------XXXX--o---------------------------------------------------SS----X---XX-----XXX----------
----------------------------------------------------------------------------------------------------o---------------------------------------------------------------------------------
------------------------------------------------------XXX---------------------------XXX---------------XXX-------------------------------------------------------ooooooo---------------
-------------------------------------------------------------------------------------------------------------------------------------------------------oooo-----ooooooo-----------E---
-----------XXXXXEXEEXXXXXXX---------------XEXXX-----------------------------------------------------------------XXXEXX-----XXXX---------------XXX------XXXX-----------E---------------
----------------------------------------------------------------------E-----E--------------------------------------------E-----------XXX-----E-----------------------<>---------------
--------XXX----------------------------------------------------------<>----<>---------------------XXX---------------------------------------<>------------------E----[]---------------
-----------------------------------------------------------XXX-------[]----[]---------------------------------------------------------------[]-----------------<>----[]--------------X
XXXXXXXXXXX---------------XXXXXXXXXXEEXEXX--------------------------X[]X--X[]XXXXX-------XXEX--------------XXXXX----------------------------[]-----------------[]----[]-------------XX
