---------------------------------------------------------------------------------------------------------------------------------------------------------------------------------------------------------------------
---------------------------------------------------------------------------------------------------------------------------------------------------------------------------------------------------------------------
---------------------------------------------------------------------------------------------------------------------------------------------------------------------------------------------------------------------
---------------------------------------------------------------------------------------------------------------------------------------------------------------------------------------------------------------------
---------------------------------------------------------------------------------------------------------------------------------------------------------------------------------------------------------------------
--------------------------------ooo------------------------------------------------?-----------------------------------------------------------------------------------------------------------E--XXX----XXX------E--
--------------------------------ooo----------------------------------------------------------------------------------------------------------------------------------------------------------------------------------
-----------------------------------------------------------------------------------E---------------------------------------------------------------------------------------------------------------------------------
-------------------oooo--------------------------------------------------------------------------------oooo----oooo---------------------------------------------------------------oooo---------X---------------------
-------------------oooo--------------------------------------------------------------------------------oooo----oooo------------S-------XXX----------------E-----------------------oooo-------------------------------
-------XX--X-----------------E-----XXXXXXEXX------------E-----------XXX-------XX-----------------------E------------------------------------------------XXX-----------XXX---XX----------XXX--------------------------
------XXX--X-----------------------X-------X-------------------------------------------------------------------------------------------------------------------------------------------------------------------------
-----XXXX--X----XXXXXXXXXXXXXXX----X-------X---XXXXXXXXXXXXXXXX-----------XX---------XXX-----XXXEXXXXXXXXXXXEXXXXXXXXX------------------------XXX---XX---------XXX--------------XXXXXXX-----------------------------X
XXXXXXXXX--X----X-------------X----X-------X---X--------------X------------------------------X-------X---------------X-----XXXXXXE----------------------------------------------X-----------------------------------X
