----------------------------------------------------------------------------------------------------------------------------------------------------------------------------------------------------------------------------------------------------
----------------------------------------------------------------------------------------------------------------------------------------------------------------------------------------------------------------------------------------------------
------------------------------------------------------------------------------------------------------------------------------------------------------------------------------------------------------------------------XXXX------------------------
-------------------------------------------------------------------------------------------------------------------------------------------------------------------------------------------------------------------------[]-------------------------
-------------------------------------------------------------------------------------------------------------------------------------------------------------------------------------------------------------------------[]---------E---------------
--------------------------------------------------------------------------E-------------------XX------------------------QQQ?QQQQQQQQ?QQQQ-----------X--------------------------------------------------------------------<>--------<>---------------
------------X--EX--------------------------------------------------------<>-------------------[]--------------------------------------[]-----------XX----XX------XX---------------------------------------------------------------X[]---------------
------------X---X--------------------------------------------------------[]-------------------[]--------------------------------------[]----------XXXXX-------------------------------------------------------------------E------XX[]---------------
------X---X-X---X--------X-EE----X-------------ooo----------------E------[]-------------------[]--------------------------------------[]---------XXXX---------------------------------------------------------------------------EXX[]---------------
------XSSSX-XSS?X--------XSSSSSSSX-------------ooo----------------------S[]-------------------<>SSSSSS--------------------SSSSSSSSSSS-<>--------XXXXX-----------------------XX-------------------------------------------------<>XX[]------------S--
--------------------------------------------------------------oo---------[]------------X-------------------------------------------------------XXXXXX----------------------XXX-------------------------------E--------------E-X[]XX[]---------------
--------------------------------------------------------------oo---------[]------------XX------E-------------------------E---E---------E------XXXXXXX-E-------------------XXXX------------------------------<>-------------<>XX[]XX[]----------SS-SS
------------------------------------EE-E------------EE-E-----------------[]------B-----XXXX------E-------------------------------------E-----XXXXXXXX<>------------------XXXXX------------------E-----------[]-------------[]XX[]XX[]--------X-SS-SS
XXXXXXXXXXXXXXXXXXXXXX--XXXXXXXXXXXXXXXXXXXXXXXXXXXXXXXXXXXXXXXXXXXXXXXXXXXXXXXXXX-----XXXXXXXXX<>XXXXXXXXXXXXXXXXXXXXXXXXXXXXXXXXXXXX<>-XXXXXXXXXXXX[]------------------XXXXXXXXXXXXXXXXXXXXXX<>-----------XXXXXXXXXXX----[]XXXXXXXXXXXXXXXXXXXXXX-
